30 22
6 6 6 6 6 6 6 6 6 6 6 6 6 6 6 6 6 6 6 6 6 6 6 6 6 6 6 6 6 6
6 6 6 6 6 6 6 6 6 6 6 6 6 6 6 6 6 6 6 6 6 6 6 6 6 6 6 6 6 6
0 0 0 0 0 0 0 0 0 0 0 6 6 6 0 0 0 0 0 0 0 0 0 0 0 0 0 6 6 6
0 0 0 0 0 0 0 0 0 2 0 6 6 6 0 4 0 0 0 0 0 0 0 0 0 2 0 6 6 6
0 0 0 0 0 0 0 0 0 0 0 6 6 6 0 0 0 0 0 0 0 0 0 0 0 0 0 6 6 6
6 6 6 6 6 6 6 6 0 0 0 6 6 6 0 0 0 6 6 6 6 6 6 6 0 0 0 6 6 6
6 6 6 6 6 6 6 6 0 0 0 6 6 6 0 0 0 6 6 6 6 6 6 6 0 0 0 6 6 6
6 6 6 6 6 6 6 6 0 0 0 6 6 6 0 0 0 6 6 6 6 6 6 6 0 0 0 6 6 6
6 6 0 0 0 0 0 0 0 0 0 6 6 6 0 0 0 6 6 6 6 6 6 6 0 0 0 6 6 6
6 6 0 4 0 0 0 0 0 3 0 6 6 6 0 0 0 6 6 6 6 6 6 6 0 0 0 6 6 6
6 6 0 0 0 0 0 0 0 0 0 6 6 6 0 0 0 6 6 6 6 6 6 6 0 0 0 6 6 6
6 6 0 0 0 6 6 6 6 6 6 6 6 6 0 0 0 6 6 6 6 6 6 6 0 0 0 6 6 6
6 6 0 0 0 6 6 6 6 6 6 6 6 6 0 0 0 6 6 6 6 6 6 6 0 0 0 6 6 6
6 6 0 0 0 6 6 6 6 6 6 6 6 6 0 0 0 6 6 6 6 6 6 6 0 0 0 6 6 6
6 6 0 0 0 6 6 6 6 6 6 6 6 6 0 0 0 6 6 6 6 6 6 6 0 0 0 6 6 6
6 6 0 0 0 0 0 0 0 0 0 0 0 0 0 0 0 6 6 6 6 6 6 6 0 0 0 0 0 0
6 6 0 5 0 0 0 0 0 0 0 0 0 0 0 3 0 6 6 6 6 6 6 6 0 5 0 0 0 0
6 6 0 0 0 0 0 0 0 0 0 0 0 0 0 0 0 6 6 6 6 6 6 6 0 0 0 0 0 0
6 6 6 6 6 6 6 6 6 6 6 6 6 6 6 6 6 6 6 6 6 6 6 6 6 6 6 6 6 6
6 6 6 6 6 6 6 6 6 6 6 6 6 6 6 6 6 6 6 6 6 6 6 6 6 6 6 6 6 6
6 6 6 6 6 6 6 6 6 6 6 6 6 6 6 6 6 6 6 6 6 6 6 6 6 6 6 6 6 6
6 6 6 6 6 6 6 6 6 6 6 6 6 6 6 6 6 6 6 6 6 6 6 6 6 6 6 6 6 6